10
150 150
150 400
400 150
650 550
250 800
150 625
750 150
650 200
500 450
800 800
0 1 1 5 0 0
0 2 1 5 0 0
0 3 1 5 0 0
0 7 1 5 0 0
1 3 1 5 0 0
1 4 1 5 0 0
2 4 1 5 0 0
2 6 1 5 0 0
2 9 1 5 0 0
3 5 1 5 0 0
3 6 1 5 0 0
4 5 1 5 0 0
6 8 1 5 0 0
6 9 1 5 0 0
7 9 1 5 0 0
