10
150 150
150 400
350 150
750 625
350 500
150 625
750 150
600 475
950 150
600 275
0 1 1 2 0
0 2 1 1 0
1 4 1 1 0
2 4 1 4 0
2 6 1 5 0
2 7 1 3 0
2 9 1 3 0
3 5 1 5 0
3 6 1 5 0
3 4 1 3 0
4 5 1 2 0
4 7 1 2 0
6 8 1 1 0
6 9 1 1 0
7 9 1 2 0
