7
150 150
400 150
250 350
550 400
350 600
150 550
700 150
0 1 1 5 1 1
0 2 1 2 1 1
1 2 1 4 2 2
1 3 1 5 2 2
1 6 1 1 2 2
2 5 1 2 2 2
2 3 1 3 2 2
2 4 1 2 2 2
4 5 1 2 2 2
