10
150 150
150 400
350 150
750 625
350 500
150 625
750 150
600 475
950 150
600 275
0 1 1 2 3
0 2 1 1 2
1 4 1 1 2
2 4 1 4 5
2 6 1 5 6
2 7 1 3 4
2 9 1 3 4
3 5 1 5 6
3 6 1 5 6
3 4 1 3 4
4 5 1 2 3
4 7 1 2 3
6 8 1 1 2
6 9 1 1 2
7 9 1 2 3
